NO ./textures/bricks.xpm
SO ./textures/greystone.xpm
WE ./textures/colorstone.xpm
EA ./textures/redbrick.xpm


F 210,180,140
C 135,206,250

11111111
10100001
10100001
10100001
10000001
10000101
10W00001
11111111
