NO ./textures/bricks.xpm
SO ./textures/greystone.xpm
WE ./textures/colorstone.xpm
EA ./textures/redbrick.xpm

F 210,180,140
C 135,206,250
        1111111111111111111111111                          
        1000000000110000000010001                          
        1101000001110000000000111                          
        1001000000000000000010001                          
111111111011000001110000000000101                          
100010000011000001110111110111001                          
101000110111110111000000100011011                          
101111110111110111010100100011001                          
101    10110100010000000010001101                          
101    1000000000011000W000100001                          
101    10000000000110101001000011                          
101    11101010111110101100111001                          
10111111 1000101 11111010001111011                          
10111111 1111111 111111111011110001                          
1001                     100011101                          
1001                     101010001                          
1001                     10101101                          
1001                     10101001                          
101111111111111111111111110101101                          
101101100001110111010100100001001                          
100000001101010111000000100010101                          
100000000000000000000000100010101                          
100000000000000011010100000000001                          
111111111111111111111111111111111                          