NO ./textures/bricks.xpm
SO ./textures/eagle.xpm
WE ./textures/colorstone.xpm
EA ./textures/redbrick.xpm

F 210,180,140
C 135,206,250

111111
100101
100001
1010W1
111111